WWWWWWWWWWWWWWWW
WS WWWS WSSWS WW
W  WWW  W  W  WW
W       W     WW 
WWWWWW  W  WWWWW
WWWWWW  W  WWSSW
WWSSWW     WW  W
WW  WW  S  WW  W
WW  WW  WWWWW  W
W              W
W  S    SSS    W
WWWWWW  WWWWWWWW
W              W
W S     W  W   W
WWWWWW  WS W   W
WWWWWWWWWWWWWWWW