WWWWWWWWWWWWWWWW
W SWWW SW  WSSWW
W  WWW  W  WSSWW
W       W   E WW 
WWWWWW  W  WWWWW
WWWWWW  W  WWSSW
WWSSWW  S  WWE W
WWE WW     WW  W
WW  WW  WWWWW  W
W SS           W
W        SSS E W
WWWWWW  WWWWWWWW
W S            W
W    EE W  W E W
WWWWWW  W  W S W
WWWWWWWWWWWWWWWW