WWWWWWWWWWWWWWWW
W SWWW SW  WSSWW
W  WWW  W  WSSWW
W       W     WW 
WWWWWW  W  WWWWW
WWWWWW  W  WWSSW
WWSSWW  S  WW  W
WW  WW     WW  W
WW  WW  WWWWW  W
W SS           W
W        SSS   W
WWWWWW  WWWWWWWW
W S            W
W       W  W   W
WWWWWW  W  W S W
WWWWWWWWWWWWWWWW