WWWWWWWWWWWWWWWW
W WSE    WSW ESW
W WWWWWW W W WWW
W WE  SW W W WSW
W WWWW   WS  W W
W WSSWW WWWW W W
W   E W W    W W
WWWWW W W WWWW W
W W W W W W  SSW
WEWSSSW W W WWWW
W    EW  SW W SW
WWW W W WWW W WW
WSW WWW     WEWW
W W  EW WWW W WW
W   W   WWW  SWW
WWWWWWWWWWWWWWWW